

dfg

NO textures/north.xpm
SO textures/south.xpm
WE textures/west.xpm
EA textures/east.xpm

C 135,245,251
F 117,0,35,59


111111111  111
1111111111111111111
       111111111111111111111111111111111111
    1111000101111000000000010111100000011111111
111100000000000100000000001011110000011
100001000000000011111110001011110000001
10100100000000001111111000000000000001
100001000010001000000000000000000000001
101001000000010000000000000000000000001
10100100000000000000000000000000000001
101001000000000000111111111100000000001
101001000000000000000000000000000000001
101001000W0000000000000000000000000001
10000100000000000010011100000011111111
100001000000000000000000001011110000001
110001000000011111111110001011110000001
111001000000000000000000000000000001111
   10000100000000000000000000000111
1111111111111111111111111111111111111111
1111   1111     1011111   1111
1111   1111111111111111111111
1111   1111
1111   1111
1111   11111111
1111111111111111111111111111111111

