



NO textures/north.xpm
SO textures/south.xpm
WE textures/west.xpm
EA textures/east.xpm   


C 135,245,251
F 117,35,59



1111111111     111         11
11111111111           1   101
1000000001     111     1   1       1
1111111111  1111                         1
1000000001
1000000001
100001001
111111111
1
11111111111111111
11111110000000001
11111111111111111
      10000S111001
      10000010011
      100111110011
      100111000011
      100010000011
      111111111111
111111111111111111
11001
11111
11101
  111
11111



