



F 27,19,1
C 35,59,0

WE textures/west.xpm
NO textures/north.xpm



SO textures/south.xpm
EA textures/east.xpm




111111111111111111111111111111111111111
100000000000000000101111000000111111111
100000000000000000000000001011110000001
100001000000000011111110001011110000001
101001000000000011111110000000000000001
10000100001000100000000000000000000001
101001000000010000000000000000000000001
101001000000000000000000000000000111111
101001000000000000111111111100000000001
101001000000000000000000000000000000001
101001000110000000000000000000000000001
100001000000000000100111000000111111111
100001000000000000000000001011110000001
100001000000011111111110001011110000001
101001000000000000000000000000000000001
100001000010000000000000000000000000001
111111111111111111111111111111111111111



