







NO textures/north.xpm
SO textures/south.xpm
WE textures/west.xpm
EA textures/east.xpm

C 135,245,251
F 117,35,59

1111111111     111
1000000001     100
1111000001     111
1000000001
100001001
1010000011
100000000111111111
111111100000000001
      100000111001
      100000001001
      100011111001
      100001100001
      100001000001
      111111111111
111111111111111111
01000
11111
1


