



NO textures/north.xpm
SO textures/south.xpm
WE textures/west.xpm  
EA textures/east.xpm    


C 251,12,11  
F 122,192,1   




11111111
11111011
11S10111
11111111
