             

egegerrg


ergerg



               ergeg  


                  
                    
            ergge         
                      
                       egeg
                        
                         
                         djkveffgleg






NO textures/north.xpm
SO textures/south.xpm
C 35,59,0
WE textures/west.xpm
F 0,35,59111 hdj
EA textures/east.xpm




111111111111111111111111111111111111111
100000000000000000101111000000111111111
11111111111111111111111111111 1111111111
                              1
111111111111111111111111111111111111111
100000000000000000000000001011110000001
100001000000000011111110001011110000001
101001000000000011111110000000000000001
100001000010001000000000000000000000001
101001000000010000000000000000000000001
101001000000000000000000000000000000001
101001000000000000111111111100000000001
101001000000000000000000000000000000001
101001000W0000000000000000000000000001
100001000000000000100111000000111111111
100001000000000000000000001011110000001
100001000000011111111110001011110000001
101001000000000000000000000000000000001
100001000010000000000000000000000000001
111111111111111111111111111111111111111






