NO      textures/north.xpm
SO textures/south.xpm
C 25,+13,+37
WE textures/west.xpm
F 0,252,59
EA textures/east.xpm





                       

    
    111111111111111111111111111111111111111
1111100000000000000101111000000111111111
100000000000000000000000001011110000001
100001000000000011111110001011110000001
101001000000000011111110000000000000001
100001000100010000000000W0000000000001
11111111111111111111111111111111111111
1                                    1
11111111111111111111111111111111111111
101001000000010000000000000000000000001
101001000000000000000000000000000000001
101001000000000000111111111100000000001
101001000000000000000000000000000000001
101001000000000000000000000000000000111
100001000000000000100111000011111111111
100001000000000000000000001011100000011
1000010000000111111111100010111100000011101
101001000000000000000000000000000000001
100001000010000000000000000000000000001
111111111111111111111111111111111111111111



