WE textures/west.xpm
NO textures/north.xpm
SO textures/south.xpm
EA textures/east.xpm
F 117,35,59
C 35,59,0

11111111111         1111
11111111111         1001
11111111111         1001
11111111111         1111
10000000001
10000000001
1000S000001
10000000001
111111111111111111111111